1111111111111111
1000000000000001
1000011100000001
100001C100000001
1000011100000001
1000000000000E01
1000111000000001
1000111000000001
100P000000000001
1111111111111111
