1111111111111111111111
1000000000000000000001
1000111111110000000001
1000111111110000000001
1000000000000000000001
1000000111000111000001
1000000111000111000001
1000000000000000000001
1000111000000111000001
1000111000000111000001
1000000000000000000P01
1000000111111100000111
100000010000010000C001
1000000100000100000001
1111111111111111111111
