1111111111
1000000001
1000111001
10C0111001
1000000001
1001111101
1001P000E1
1001111101
1000000001
1111111111
