1111111111
1000000001
1000c00001
1001111001
10000e0001
1111111101
1000000001
1pc0000001
1111111111