1111a
1ce1a
10p1a
1111a
aaaaa
