111111111
1C000E001
1C0CCC1P1
111111111
