1111111111
1000000001
1pec000001
1111111111
