1111111111
1000000001
1000000001
100p000001
1000000001
1000000001
10000e0001
1000000001
1000000001
1111111111
