111111111111111111
100000000000000001
100011111100000001
100011111100000001
100000001100000001
1000000011E0000001
100000001100000001
100000000000000001
100000111111100001
100000100001100001
1000001P0001100001
111111111111111111
