111111111111111111111111111111
100000000000000000000000000001
10C000111100000000000011111001
100001000000000001100100001001
100001111110000001100100001001
111100000010000000000000001001
100000000010111111111111101001
100000000010100000000000001001
100000000010100000P00000001001
100000011110111111100111111001
100000010000000000100100000001
100000010000000000100100000001
100000011111111111100100000001
100000000000000000000100000001
100000000000000000000100000001
100000000000000000000100000001
100000000000000000000100000001
1000000000000000000001000E0001
111111111111111111111111111111
